姓名,班級,數學,英文,國文,自然,社會,總分,平均,是否及格
Alice,A,95,88,90,85,80,438,87.6,True
Bob,B,58,92,60,55,60,325,65.0,True
Charlie,A,77,85,80,70,90,402,80.4,True
David,B,45,70,55,60,50,280,56.0,False
Eva,A,88,95,92,89,85,449,89.8,True
Frank,C,60,65,70,55,60,310,62.0,True
Grace,C,100,98,95,90,92,475,95.0,True
Henry,B,72,68,75,80,78,373,74.6,True
Ivy,A,55,80,65,60,70,330,66.0,True
Jack,C,83,77,82,85,80,407,81.4,True
